111111111111
11CCCCC0CPE1
111111111111
