1111111111111111111111
10010000E0000000000001
100001111000000C000001
100000000000000M000001
1P000100000M0000000001
1000010000000000000001
100001000C0000000M0001
1111111111111111111111
