1111111111111111111111
10010000E0000000000001
100001111000000C000001
1000000M00000000000001
1P00010000000000000001
10000100000000M0000001
100001000C000000000001
1111111111111111111111
