1111111111
10010000E1
100CC11111
10000C0001
1P0001C001
1111111111
