1111111111
10010000E1
100C011111
1000000001
1P0001C001
1111111111
